話をする	の	下のような
彩色を見る	の	今主人の
問答をする	の	左の
御馳走をあるく	の	鼠以外の
注意を惹く	の	吾輩の
仕付を受ける	ばかり	御三ばかりじゃない
返事をする	の	対句のような
慰安を求める	の	一道の
位置をする	の	臓腑の
弁解をする	とか	かんとか
挨拶をする	の	見当違いの
挨拶をする	の	一応の
形容をなさる	の や	シチュの 御話や
通信を読む	の	戦争の
研究を続ける	の	方面の
御馳走を致す	の	トチメンボーの
研究を尽す	と	めんと
著述を居る	の	スミス等諸家の
講釈をする	の	名前の
苦心を買う	の	せっかくの
復讐をとる	と の	舌と トチメンボーの
経験をする	の	教場の
真似をする	の	首縊りの
談判をする	の	手詰の
手続きを踏む	の	正当の
苦労をする	の	身上の
世話をする	の	小供の
覚悟をする	くらい	くらいの
話を聞く	の	今の
損害を償う	の	ジャムの
返答をする	の	迷亭の
定義をする	の	月並の
処置を付ける	の	月並の
専断を憤る	の	迷亭の
挨拶を終る	の	初対面の
研究をやる	の	磁気の
質問をえる	の	大抵の
訪問を受ける	の	鼻子の
許諾を至る	の	人の
注意を惹く	の	人の
清聴を煩わす	の	御両君の
真似をやる	の	演舌の
復讐をやる	の	先日の
出入を禁ずる	の	他の
依頼をする	の	金田君の
試験をする	の	頭の
平均を破る	の	心の
平均を破る	の	心の
問答をやる	の	無言の
説明をする	の	現象の
依頼をうける	の	金田夫婦の
観察を積む	の	数千年来の
製造を負う	の	人間の
変化を示す	ほど	ほどの
発展をする	の	事件の
休養を要する	の	暫時の
意味を聞かす	の	オタンチン・パレオロガスの
約束を覚える	の	先日の
修行をする	の	躄の
活動を見る	の	形体以外の
代理を勤める	の	引窓の
区劃を立てる	の	人為的の
いたずらをする	か	あまりかような
観察を怠る	の	人間社会の
逆戻りをする	の	気候の
談話を分る	の	三人の
失恋をする	の	迷亭君の
話を聞く	の	噺し家の
返事を待つ	の	御夏さんの
交換をやる	の	霊の
話をする	の	呉服屋の
話をする	の	人売りの
体操をする	の	彼等の
講義を行く	の	Hierophilusの
創作をやる	の	東風君僕の
行水を見下ろす	の	女の
演説をする	の	大和魂の
芝居をする	の	大和魂の
往生をあがる	の	魚の
寂滅をごねる	の	人間の
広告を出す	と	四百四病即席全快と
変化を起こす	の	黒白の
御馳走をする	の	最明寺の
猶予を与える	の	三分間の
反応をする	の	何等の
影響を与える	な	くらいな
代理を務める	の	三介の
観察を怠る	の	方の
北面を取り囲む	の	臥竜窟の
喧嘩を見る	の	小犬の
出所をする	の	声の
逆上をする	の	種の
真似をする	の	古人の
発達を立てる	か	幾分か
不足を訴える	の	営養の
砲撃を食う	の	二週間の
戦闘をする	と	敵と
講義をする	の	倫理の
意味をする	の	やりの
遊戯をくだける	の	近所迷惑の
講義をきく	の	倫理の
挨拶をする	の	竜頭蛇尾の
留守をする	の	金田君の
談話をする	の	偶然君の
談話を聞く	の	両君の
喧嘩を思う	と	落雲館との
忠告を容れる	の	彼の
了見を起す	など	見ようなどという
観念をする	の	二個の
苦難を忍ぶ	の	寒暑の
修養を力む	の	精神の
講釈を聞く	の	床の間の
由来を聞く	の	鉄扇の
修養をする	の	精神の
主宰をもつ	の	天道の
了見を起す	で	飛んでもない
掃除を始める	の	例のごとき
連想をかたちづくる	の	器械的の
失望を受取る	の	最後の
催促をしてやる	の	朝飯の
襲撃を蒙る	の	野良犬の
掃除をする	の	書斎の
真似をする	の	独乙皇帝陛下の
定義を云う	の	人間の
相談を持ちかける	て	向ってかような
真似をする	の	何の
ストライキをしでかす	や	排斥運動や
質問をかける	て	向ってさえかような
稽古を始める	の	自転車の
摩擦を与える	の	多くの
話を聞く	の	虎の
行動をとる	の	各自任意の
稽古をはじめる	の	ヴァイオリンの
処分を受ける	の	退校の
下宿を出る	の	村の
話をきく	の	君の
仲間入りをする	の	ヴァイオリンの
同情をこめる	の	満腹の
懐中を抜く	の	人の
修行をする	の	心の
